"filename", "language", "Dart", "comment", "blank", "total"
"d:\Flutter\old_version\lib\controller\add_account_controller.dart", "Dart", 439, 28, 42, 509
"d:\Flutter\old_version\lib\controller\cashier\cashier_constant_controller.dart", "Dart", 342, -98, 5, 249
"d:\Flutter\old_version\lib\controller\cashier\cashier_controller.dart", "Dart", 5, 0, 0, 5
"d:\Flutter\old_version\lib\controller\catagories\catagories_add_controller.dart", "Dart", -55, -1, -7, -63
"d:\Flutter\old_version\lib\controller\catagories\catagories_controller.dart", "Dart", 167, 10, 40, 217
"d:\Flutter\old_version\lib\controller\catagories\catagories_view_controller.dart", "Dart", -90, -3, -11, -104
"d:\Flutter\old_version\lib\controller\catagories\categories_edit_controller.dart", "Dart", -46, 0, -8, -54
"d:\Flutter\old_version\lib\controller\home\home_controller.dart", "Dart", 89, 0, -1, 88
"d:\Flutter\old_version\lib\controller\imp_exp\import_controller.dart", "Dart", -14, 16, -2, 0
"d:\Flutter\old_version\lib\controller\imp_exp\import_export_controller.dart", "Dart", 102, 6, 7, 115
"d:\Flutter\old_version\lib\controller\imp_exp\transaction_controller.dart", "Dart", 184, 42, 14, 240
"d:\Flutter\old_version\lib\controller\imp_exp\transaction_payment_controller.dart", "Dart", 120, 3, 10, 133
"d:\Flutter\old_version\lib\controller\imp_exp\transaction_receipt_controller.dart", "Dart", 119, 3, 10, 132
"d:\Flutter\old_version\lib\controller\items\items_add_controller.dart", "Dart", -12, -2, 0, -14
"d:\Flutter\old_version\lib\controller\items\items_definition_controller.dart", "Dart", 144, -1, -5, 138
"d:\Flutter\old_version\lib\controller\items\items_update_controller.dart", "Dart", -9, 0, -1, -10
"d:\Flutter\old_version\lib\controller\items\items_view_controller.dart", "Dart", 84, 0, 9, 93
"d:\Flutter\old_version\lib\controller\printer\invoice_controller.dart", "Dart", -14, 13, 0, -1
"d:\Flutter\old_version\lib\controller\reports\daily_reports\daily_reports_controller.dart", "Dart", 607, 24, 41, 672
"d:\Flutter\old_version\lib\controller\reports\reports_controller.dart", "Dart", 0, 383, 29, 412
"d:\Flutter\old_version\lib\controller\setting\setting_controller.dart", "Dart", -2, 0, 0, -2
"d:\Flutter\old_version\lib\core\class\handling_data_view.dart", "Dart", 72, 0, 7, 79
"d:\Flutter\old_version\lib\core\class\statusrequest.dart", "Dart", 1, 0, 0, 1
"d:\Flutter\old_version\lib\core\constant\imgaeasset.dart", "Dart", 11, 0, 0, 11
"d:\Flutter\old_version\lib\core\constant\routes.dart", "Dart", 8, 2, 4, 14
"d:\Flutter\old_version\lib\core\constant\screen_routes.dart", "Dart", 10, 2, 0, 12
"d:\Flutter\old_version\lib\core\dialogs\confirm_dialog.dart", "Dart", 9, 0, 1, 10
"d:\Flutter\old_version\lib\core\dialogs\delete_dialog.dart", "Dart", 1, 0, 0, 1
"d:\Flutter\old_version\lib\core\dialogs\error_dialogs.dart", "Dart", 1, 0, 0, 1
"d:\Flutter\old_version\lib\core\dialogs\show_form_dialog.dart", "Dart", 93, 0, 4, 97
"d:\Flutter\old_version\lib\core\dialogs\snackbar_helper.dart", "Dart", 54, 0, 5, 59
"d:\Flutter\old_version\lib\core\functions\date_picker.dart", "Dart", 20, 0, 3, 23
"d:\Flutter\old_version\lib\core\functions\handle_data_function.dart", "Dart", -2, 0, 0, -2
"d:\Flutter\old_version\lib\core\functions\validinput.dart", "Dart", 3, 0, 0, 3
"d:\Flutter\old_version\lib\core\localization\ar_translation.dart", "Dart", 399, 14, 11, 424
"d:\Flutter\old_version\lib\core\localization\en_translation.dart", "Dart", 423, 12, 6, 441
"d:\Flutter\old_version\lib\core\localization\text_routes.dart", "Dart", 271, 8, 7, 286
"d:\Flutter\old_version\lib\core\localization\translation.dart", "Dart", -527, 529, 0, 2
"d:\Flutter\old_version\lib\core\middleware\mymiddleware.dart", "Dart", 2, 0, 0, 2
"d:\Flutter\old_version\lib\core\responsive\responsive_builder.dart", "Dart", -13, -2, -4, -19
"d:\Flutter\old_version\lib\core\responsive\screen_builder.dart", "Dart", 23, 2, 6, 31
"d:\Flutter\old_version\lib\core\services\services.dart", "Dart", -12, 12, 0, 0
"d:\Flutter\old_version\lib\core\shared\custom_drop_down_laptop_details.dart", "Dart", -211, -1, -7, -219
"d:\Flutter\old_version\lib\core\shared\custom_drop_down_search.dart", "Dart", -103, -2, -6, -111
"d:\Flutter\old_version\lib\core\shared\custom_drop_down_search_items.dart", "Dart", -182, -1, -8, -191
"d:\Flutter\old_version\lib\core\shared\custom_drop_down_search_users.dart", "Dart", -171, -1, -7, -179
"d:\Flutter\old_version\lib\core\shared\custom_formfield_global.dart", "Dart", -1, 0, 0, -1
"d:\Flutter\old_version\lib\core\shared\custom_header_screen.dart", "Dart", 2, 0, 5, 7
"d:\Flutter\old_version\lib\core\shared\custom_sized_box.dart", "Dart", 5, 0, 1, 6
"d:\Flutter\old_version\lib\core\shared\custom_text_field_widget.dart", "Dart", 97, 1, 4, 102
"d:\Flutter\old_version\lib\core\shared\drop_downs\custom_drop_down_search.dart", "Dart", 108, 1, 6, 115
"d:\Flutter\old_version\lib\core\shared\drop_downs\custom_drop_down_search_items.dart", "Dart", 182, 1, 8, 191
"d:\Flutter\old_version\lib\core\shared\drop_downs\custom_drop_down_search_users.dart", "Dart", 165, 1, 8, 174
"d:\Flutter\old_version\lib\core\shared\drop_downs\drop_down_menu.dart", "Dart", 59, 0, 5, 64
"d:\Flutter\old_version\lib\core\shared\drop_downs\drop_down_units.dart", "Dart", 106, 1, 6, 113
"d:\Flutter\old_version\lib\core\shared\drop_downs\sort_drop_down.dart", "Dart", 64, 0, 4, 68
"d:\Flutter\old_version\lib\data\model\account_model.dart", "Dart", 47, 0, 3, 50
"d:\Flutter\old_version\lib\data\model\cart_model.dart", "Dart", -34, 1, 0, -33
"d:\Flutter\old_version\lib\data\model\categories_model.dart", "Dart", 6, 0, -2, 4
"d:\Flutter\old_version\lib\data\model\item_details_model.dart", "Dart", 36, 0, 4, 40
"d:\Flutter\old_version\lib\data\model\items_model.dart", "Dart", -150, -7, -4, -161
"d:\Flutter\old_version\lib\data\model\locale\account_menu_model.dart", "Dart", 12, 0, 1, 13
"d:\Flutter\old_version\lib\data\model\locale\custom_units_list.dart", "Dart", 2, 0, 0, 2
"d:\Flutter\old_version\lib\data\model\locale\unit_types.dart", "Dart", 5, 0, 1, 6
"d:\Flutter\old_version\lib\data\model\reports\account_statement_model.dart", "Dart", 44, 0, 4, 48
"d:\Flutter\old_version\lib\data\model\reports\box_transaction_model.dart", "Dart", 48, 0, 4, 52
"d:\Flutter\old_version\lib\data\model\reports\customer_ledger_model.dart", "Dart", 48, 0, 4, 52
"d:\Flutter\old_version\lib\data\model\reports\general_ledger_model.dart", "Dart", 64, 0, 4, 68
"d:\Flutter\old_version\lib\data\model\reports\retained_earnings_model.dart", "Dart", 48, 0, 4, 52
"d:\Flutter\old_version\lib\data\model\reports\supplier_ledger_model.dart", "Dart", 48, 0, 4, 52
"d:\Flutter\old_version\lib\data\model\reports\trial_balance_model.dart", "Dart", 32, 0, 4, 36
"d:\Flutter\old_version\lib\data\model\reports\withdraw_model.dart", "Dart", 48, 0, 4, 52
"d:\Flutter\old_version\lib\data\model\supplier_model.dart", "Dart", 48, 0, 4, 52
"d:\Flutter\old_version\lib\data\model\transaction_model.dart", "Dart", 62, 0, 6, 68
"d:\Flutter\old_version\lib\data\model\units_model.dart", "Dart", -3, 0, 0, -3
"d:\Flutter\old_version\lib\data\model\users_model.dart", "Dart", 0, 0, 1, 1
"d:\Flutter\old_version\lib\data\source\account_class.dart", "Dart", 112, 0, 18, 130
"d:\Flutter\old_version\lib\data\source\cashier_class.dart", "Dart", -15, -1, 0, -16
"d:\Flutter\old_version\lib\data\source\items_class.dart", "Dart", 31, -4, 0, 27
"d:\Flutter\old_version\lib\data\source\reports_data.dart", "Dart", 440, 52, 55, 547
"d:\Flutter\old_version\lib\data\source\transaction_class.dart", "Dart", 143, 2, 20, 165
"d:\Flutter\old_version\lib\main.dart", "Dart", 17, 0, 1, 18
"d:\Flutter\old_version\lib\view\add_account\add_account_screen.dart", "Dart", 19, 0, 3, 22
"d:\Flutter\old_version\lib\view\add_account\components\account_tree_menu.dart", "Dart", 61, 0, 4, 65
"d:\Flutter\old_version\lib\view\add_account\components\add_users_account_dialog.dart", "Dart", 82, 0, 3, 85
"d:\Flutter\old_version\lib\view\add_account\components\show_add_account_dialog.dart", "Dart", 86, 1, 3, 90
"d:\Flutter\old_version\lib\view\add_account\mobile\add_account_screen_mobile.dart", "Dart", 8, 0, 2, 10
"d:\Flutter\old_version\lib\view\add_account\windows\add_account_screen_windows.dart", "Dart", 239, 6, 10, 255
"d:\Flutter\old_version\lib\view\buying\components\buying_table_view.dart", "Dart", -1, 0, 0, -1
"d:\Flutter\old_version\lib\view\buying\mobile\buying_screen_mobile.dart", "Dart", -1, 0, 0, -1
"d:\Flutter\old_version\lib\view\buying\windows\buying_screen_windows.dart", "Dart", -3, 0, 0, -3
"d:\Flutter\old_version\lib\view\buying\windows\view_details\view_buying_details_screen.dart", "Dart", -5, 0, 0, -5
"d:\Flutter\old_version\lib\view\cashier\cashier_screen.dart", "Dart", -13, -2, 1, -14
"d:\Flutter\old_version\lib\view\cashier\components\drop_down_search_users_cashier.dart", "Dart", 170, 1, 7, 178
"d:\Flutter\old_version\lib\view\cashier\mobile\components\bottom_cashier_buttons.dart", "Dart", -189, 2, 2, -185
"d:\Flutter\old_version\lib\view\cashier\mobile\components\custom_payment_dialog_mobile.dart", "Dart", 0, -2, -1, -3
"d:\Flutter\old_version\lib\view\cashier\mobile\components\footer_details_widget.dart", "Dart", 3, 0, 0, 3
"d:\Flutter\old_version\lib\view\cashier\mobile\components\pending_carts_mobile.dart", "Dart", 3, 0, 3, 6
"d:\Flutter\old_version\lib\view\cashier\mobile\components\search_widget_mobile.dart", "Dart", 6, -1, 0, 5
"d:\Flutter\old_version\lib\view\cashier\windows\action\cashier_action_side.dart", "Dart", 200, 5, 3, 208
"d:\Flutter\old_version\lib\view\cashier\windows\action\cashier_right_side.dart", "Dart", -210, -5, -3, -218
"d:\Flutter\old_version\lib\view\cashier\windows\action\components\custom_cashier_dialog.dart", "Dart", 73, 5, 4, 82
"d:\Flutter\old_version\lib\view\cashier\windows\action\components\custom_diplay_users.dart", "Dart", -157, -2, -7, -166
"d:\Flutter\old_version\lib\view\cashier\windows\action\components\export_pdf_dialog.dart", "Dart", 1, 0, 0, 1
"d:\Flutter\old_version\lib\view\cashier\windows\action\components\payment_dialog.dart", "Dart", -1, 3, 0, 2
"d:\Flutter\old_version\lib\view\cashier\windows\action\components\show_last_invoices.dart", "Dart", 1, 0, 0, 1
"d:\Flutter\old_version\lib\view\cashier\windows\view\cashier_left_side_screen.dart", "Dart", -158, -7, -8, -173
"d:\Flutter\old_version\lib\view\cashier\windows\view\cashier_view_section_screen.dart", "Dart", 181, 3, 10, 194
"d:\Flutter\old_version\lib\view\cashier\windows\view\components\cashier_drop_down.dart", "Dart", -66, 0, -4, -70
"d:\Flutter\old_version\lib\view\cashier\windows\view\components\cashier_table_rows.dart", "Dart", -6, 1, 7, 2
"d:\Flutter\old_version\lib\view\cashier\windows\view\components\custom_grid_data_view.dart", "Dart", -13, 8, 4, -1
"d:\Flutter\old_version\lib\view\cashier\windows\view\components\custom_pending_cart.dart", "Dart", 2, 135, 5, 142
"d:\Flutter\old_version\lib\view\cashier\windows\view\components\search_box_widget.dart", "Dart", -22, 0, -3, -25
"d:\Flutter\old_version\lib\view\cashier\windows\view\components\show_drop_down_items_dialog.dart", "Dart", -155, 0, -5, -160
"d:\Flutter\old_version\lib\view\categories\categories_add_screen.dart", "Dart", 18, 0, 3, 21
"d:\Flutter\old_version\lib\view\categories\categories_edit_screen.dart", "Dart", 19, 0, 3, 22
"d:\Flutter\old_version\lib\view\categories\mobile\add_categories_mobile.dart", "Dart", -55, 0, -3, -58
"d:\Flutter\old_version\lib\view\categories\mobile\categories_screen_mobile.dart", "Dart", -91, -1, 0, -92
"d:\Flutter\old_version\lib\view\categories\widgets\add_category_form.dart", "Dart", 168, 1, 6, 175
"d:\Flutter\old_version\lib\view\categories\widgets\categories_card_widget.dart", "Dart", 135, 2, 2, 139
"d:\Flutter\old_version\lib\view\categories\widgets\view_categories_widget.dart", "Dart", 46, 0, 7, 53
"d:\Flutter\old_version\lib\view\categories\windows\add_catagories_widget.dart", "Dart", -53, 0, -3, -56
"d:\Flutter\old_version\lib\view\categories\windows\categories_add_screen_windows.dart", "Dart", 61, 2, 4, 67
"d:\Flutter\old_version\lib\view\categories\windows\categries_screen_windows.dart", "Dart", -18, 0, 1, -17
"d:\Flutter\old_version\lib\view\categories\windows\edit_categories_screen.dart", "Dart", -58, 0, -3, -61
"d:\Flutter\old_version\lib\view\categories\windows\view_categories_widget.dart", "Dart", -106, -1, -3, -110
"d:\Flutter\old_version\lib\view\home\desktop\home_widget_list.dart", "Dart", 7, 0, 0, 7
"d:\Flutter\old_version\lib\view\home\drawer\acount_screen.dart", "Dart", 4, 0, -1, 3
"d:\Flutter\old_version\lib\view\home\mobile\home_screen_mobile.dart", "Dart", 2, 0, 1, 3
"d:\Flutter\old_version\lib\view\home\mobile\how_widget_list_mobile.dart", "Dart", 13, -1, 0, 12
"d:\Flutter\old_version\lib\view\imp_exp\components\account_drop_down_widget.dart", "Dart", 150, 0, 5, 155
"d:\Flutter\old_version\lib\view\imp_exp\components\add_transaction_form_dialog.dart", "Dart", 84, 2, 3, 89
"d:\Flutter\old_version\lib\view\imp_exp\components\custom_drop_down_impexp.dart", "Dart", 116, 1, 5, 122
"d:\Flutter\old_version\lib\view\imp_exp\components\custom_expansion_tile.dart", "Dart", 67, 0, 3, 70
"d:\Flutter\old_version\lib\view\imp_exp\components\edit_import_export.dart", "Dart", 115, 0, 4, 119
"d:\Flutter\old_version\lib\view\imp_exp\desktop\export\export_add_widget.dart", "Dart", 123, 0, 3, 126
"d:\Flutter\old_version\lib\view\imp_exp\desktop\export\export_search_widget.dart", "Dart", 228, 0, 3, 231
"d:\Flutter\old_version\lib\view\imp_exp\desktop\export\export_table_widget.dart", "Dart", 182, 14, 6, 202
"d:\Flutter\old_version\lib\view\imp_exp\desktop\import\import_add_widget.dart", "Dart", 126, 0, 3, 129
"d:\Flutter\old_version\lib\view\imp_exp\desktop\import\import_screen.dart", "Dart", 49, 3, 6, 58
"d:\Flutter\old_version\lib\view\imp_exp\desktop\import\import_search_widget.dart", "Dart", 181, 21, 3, 205
"d:\Flutter\old_version\lib\view\imp_exp\desktop\import\import_table_widget.dart", "Dart", 125, 0, 6, 131
"d:\Flutter\old_version\lib\view\imp_exp\export_screen.dart", "Dart", 17, 99, 8, 124
"d:\Flutter\old_version\lib\view\imp_exp\import_export_screen.dart", "Dart", 135, 0, 4, 139
"d:\Flutter\old_version\lib\view\imp_exp\import_screen.dart", "Dart", 17, 0, 4, 21
"d:\Flutter\old_version\lib\view\imp_exp\mobile\export\export_add_widget_mobile.dart", "Dart", 121, 0, 3, 124
"d:\Flutter\old_version\lib\view\imp_exp\mobile\export\export_screen_mobile.dart", "Dart", 58, 0, 4, 62
"d:\Flutter\old_version\lib\view\imp_exp\mobile\export\export_search_widget_mobile.dart", "Dart", 179, 0, 3, 182
"d:\Flutter\old_version\lib\view\imp_exp\mobile\import\import_add_widget_mobile.dart", "Dart", 113, 0, 3, 116
"d:\Flutter\old_version\lib\view\imp_exp\mobile\import\import_screen_mobile.dart", "Dart", 106, 0, 4, 110
"d:\Flutter\old_version\lib\view\imp_exp\mobile\import\import_search_widget_mobile.dart", "Dart", 174, 0, 3, 177
"d:\Flutter\old_version\lib\view\import_export\desktop\export\export_add_widget.dart", "Dart", -122, 0, -3, -125
"d:\Flutter\old_version\lib\view\import_export\desktop\export\export_screen.dart", "Dart", -96, -5, -5, -106
"d:\Flutter\old_version\lib\view\import_export\desktop\export\export_search_widget.dart", "Dart", -229, 0, -3, -232
"d:\Flutter\old_version\lib\view\import_export\desktop\export\export_table_widget.dart", "Dart", -182, -14, -6, -202
"d:\Flutter\old_version\lib\view\import_export\desktop\import\import_add_widget.dart", "Dart", -117, 0, -3, -120
"d:\Flutter\old_version\lib\view\import_export\desktop\import\import_screen.dart", "Dart", -87, -5, -4, -96
"d:\Flutter\old_version\lib\view\import_export\desktop\import\import_search_widget.dart", "Dart", -222, 0, -3, -225
"d:\Flutter\old_version\lib\view\import_export\desktop\import\import_table_widget.dart", "Dart", -180, -14, -6, -200
"d:\Flutter\old_version\lib\view\import_export\import_export_screen.dart", "Dart", -18, 0, -4, -22
"d:\Flutter\old_version\lib\view\import_export\mobile\export\export_add_widget_mobile.dart", "Dart", -120, 0, -3, -123
"d:\Flutter\old_version\lib\view\import_export\mobile\export\export_screen_mobile.dart", "Dart", -58, 0, -4, -62
"d:\Flutter\old_version\lib\view\import_export\mobile\export\export_search_widget_mobile.dart", "Dart", -178, 0, -3, -181
"d:\Flutter\old_version\lib\view\import_export\mobile\import\import_add_widget_mobile.dart", "Dart", -112, 0, -3, -115
"d:\Flutter\old_version\lib\view\import_export\mobile\import\import_screen_mobile.dart", "Dart", -106, 0, -4, -110
"d:\Flutter\old_version\lib\view\import_export\mobile\import\import_search_widget_mobile.dart", "Dart", -173, 0, -3, -176
"d:\Flutter\old_version\lib\view\import_export\shared\custom_drop_down_impexp.dart", "Dart", -116, -1, -5, -122
"d:\Flutter\old_version\lib\view\import_export\shared\custom_expansion_tile.dart", "Dart", -67, 0, -3, -70
"d:\Flutter\old_version\lib\view\import_export\shared\edit_import_export.dart", "Dart", -114, 0, -4, -118
"d:\Flutter\old_version\lib\view\inventory\windows\inventory_screen_windows.dart", "Dart", -3, 0, 0, -3
"d:\Flutter\old_version\lib\view\items\items_add_screen.dart", "Dart", 14, 0, 3, 17
"d:\Flutter\old_version\lib\view\items\items_edit_screen.dart", "Dart", 14, 0, 3, 17
"d:\Flutter\old_version\lib\view\items\items_screen.dart", "Dart", 137, 0, 1, 138
"d:\Flutter\old_version\lib\view\items\items_view_screen.dart", "Dart", 17, 0, 3, 20
"d:\Flutter\old_version\lib\view\items\mobile\add_items_screen_mobile.dart", "Dart", -27, 0, -3, -30
"d:\Flutter\old_version\lib\view\items\mobile\items_add_screen_mobile.dart", "Dart", 28, 0, 3, 31
"d:\Flutter\old_version\lib\view\items\mobile\items_edit_screen_mobile.dart", "Dart", 28, 0, 3, 31
"d:\Flutter\old_version\lib\view\items\mobile\items_screen_mobile.dart", "Dart", -129, 0, -5, -134
"d:\Flutter\old_version\lib\view\items\mobile\items_view_screen_mobile.dart", "Dart", 76, 0, 5, 81
"d:\Flutter\old_version\lib\view\items\mobile\update_items_screen_mobile.dart", "Dart", -27, 0, -3, -30
"d:\Flutter\old_version\lib\view\items\widget\custom_add_items.dart", "Dart", 132, 0, 0, 132
"d:\Flutter\old_version\lib\view\items\widget\custom_show_items.dart", "Dart", 99, 13, 5, 117
"d:\Flutter\old_version\lib\view\items\widget\custom_update_widget.dart", "Dart", -5, -3, -1, -9
"d:\Flutter\old_version\lib\view\items\widget\items_button_actions.dart", "Dart", 78, 0, 2, 80
"d:\Flutter\old_version\lib\view\items\widget\items_details_dialog.dart", "Dart", 150, 0, 10, 160
"d:\Flutter\old_version\lib\view\items\widget\mobile_action_widget.dart", "Dart", -25, 0, 0, -25
"d:\Flutter\old_version\lib\view\items\widget\upload_image.dart", "Dart", 73, 0, 5, 78
"d:\Flutter\old_version\lib\view\items\windows\items_add_screen.dart", "Dart", -91, 0, -3, -94
"d:\Flutter\old_version\lib\view\items\windows\items_add_screen_windows.dart", "Dart", 72, 0, 3, 75
"d:\Flutter\old_version\lib\view\items\windows\items_screen_windows.dart", "Dart", -228, 0, -4, -232
"d:\Flutter\old_version\lib\view\items\windows\items_update_screen.dart", "Dart", -60, 0, -3, -63
"d:\Flutter\old_version\lib\view\items\windows\items_update_screen_windows.dart", "Dart", 38, 0, 3, 41
"d:\Flutter\old_version\lib\view\items\windows\items_view_screen_windows.dart", "Dart", 182, 0, 4, 186
"d:\Flutter\old_version\lib\view\reports\billing_profits\billing_profits_screen.dart", "Dart", 8, 0, 2, 10
"d:\Flutter\old_version\lib\view\reports\components\drop_down_accounts_search.dart", "Dart", 133, 0, 4, 137
"d:\Flutter\old_version\lib\view\reports\components\reports_action_buttons.dart", "Dart", 60, 1, 2, 63
"d:\Flutter\old_version\lib\view\reports\daily_reports\account_statement\account_statement_table.dart", "Dart", 67, 5, 3, 75
"d:\Flutter\old_version\lib\view\reports\daily_reports\bank\bank_table.dart", "Dart", 72, 5, 3, 80
"d:\Flutter\old_version\lib\view\reports\daily_reports\box\box_table.dart", "Dart", 68, 5, 3, 76
"d:\Flutter\old_version\lib\view\reports\daily_reports\customer\customer_table.dart", "Dart", 67, 5, 3, 75
"d:\Flutter\old_version\lib\view\reports\daily_reports\daily_reports_screen.dart", "Dart", 231, 2, 3, 236
"d:\Flutter\old_version\lib\view\reports\daily_reports\general_ledger\general_ledger_table.dart", "Dart", 67, 5, 3, 75
"d:\Flutter\old_version\lib\view\reports\daily_reports\retained_earnings\retained_earnings_table.dart", "Dart", 67, 5, 3, 75
"d:\Flutter\old_version\lib\view\reports\daily_reports\supplier\supplier_table.dart", "Dart", 67, 5, 3, 75
"d:\Flutter\old_version\lib\view\reports\daily_reports\trial_balance\trial_balance_table.dart", "Dart", 65, 5, 3, 73
"d:\Flutter\old_version\lib\view\reports\daily_reports\withdraw\withdraw_table.dart", "Dart", 67, 5, 3, 75
"d:\Flutter\old_version\lib\view\reports\financial_reports\financial_reports_screen.dart", "Dart", 8, 0, 2, 10
"d:\Flutter\old_version\lib\view\reports\inventory_reports\inventory_reports_screen.dart", "Dart", 8, 0, 2, 10
"d:\Flutter\old_version\lib\view\reports\reports_screen.dart", "Dart", 149, 0, 4, 153
"d:\Flutter\old_version\lib\view\settings\invoices\shared\design_barcode.dart", "Dart", -3, 0, 0, -3
"d:\Flutter\old_version\lib\view\settings\invoices\shared\printing_barcode.dart", "Dart", -3, 0, 0, -3
"d:\Flutter\old_version\lib\view\settings\invoices\windows\invoices_screen_windows.dart", "Dart", -1, 0, 0, -1
"d:\Flutter\old_version\lib\view\settings\windows\right_side_widget.dart", "Dart", -3, 0, 0, -3
"d:\Flutter\old_version\lib\view\transactions\components\action_row_buttton_widget.dart", "Dart", 42, 0, 2, 44
"d:\Flutter\old_version\lib\view\transactions\payment\widgets\transaction_drop_down_payment_accounts.dart", "Dart", 152, 0, 5, 157
"d:\Flutter\old_version\lib\view\transactions\payment\widgets\transaction_payment_dialog_form_widget.dart", "Dart", 86, 0, 3, 89
"d:\Flutter\old_version\lib\view\transactions\payment\widgets\transaction_payment_table_widget.dart", "Dart", 118, 0, 6, 124
"d:\Flutter\old_version\lib\view\transactions\payment\windows\transaction_payment_windows_screen.dart", "Dart", 154, 3, 6, 163
"d:\Flutter\old_version\lib\view\transactions\receipt\mobile\transaction_receipt_mobile_screen.dart", "Dart", 8, 0, 2, 10
"d:\Flutter\old_version\lib\view\transactions\receipt\widgets\transaction_drop_down_receipt_accounts.dart", "Dart", 152, 0, 5, 157
"d:\Flutter\old_version\lib\view\transactions\receipt\widgets\transaction_receipt_dialog_form.dart", "Dart", 86, 0, 3, 89
"d:\Flutter\old_version\lib\view\transactions\receipt\widgets\transaction_receipt_table_widget.dart", "Dart", 149, 27, 9, 185
"d:\Flutter\old_version\lib\view\transactions\receipt\windows\transaction_receipt_windows_screen.dart", "Dart", 154, 3, 7, 164
"d:\Flutter\old_version\lib\view\transactions\transaction_receipt_screen.dart", "Dart", 16, 0, 3, 19
"d:\Flutter\old_version\lib\view\transactions\transactions_payment_screen.dart", "Dart", 15, 0, 3, 18
"d:\Flutter\old_version\lib\view\transactions\transactions_screen.dart", "Dart", 135, 0, 4, 139
"d:\Flutter\old_version\lib\view\widgets\tables\custom_table_cell.dart", "Dart", 2, 0, 0, 2
"d:\Flutter\old_version\lib\view\widgets\tables\custom_table_cell_change_number.dart", "Dart", -1, 0, 0, -1
"d:\Flutter\old_version\lib\view\widgets\tables\custom_table_widget.dart", "Dart", 0, 0, 1, 1
"d:\Flutter\old_version\lib\view\widgets\tables\table_cell.dart", "Dart", 35, 1, 6, 42
"d:\Flutter\old_version\lib\view\widgets\tables\table_cell_change_number.dart", "Dart", 49, 0, 2, 51
"d:\Flutter\old_version\lib\view\widgets\tables\table_widget.dart", "Dart", 187, 1, 7, 195
"Total", "-", 7938, 1392, 603, 9933