"filename", "language", "Dart", "comment", "blank", "total"
"d:\Flutter\old_version\lib\controller\auth\login_controller.dart", "Dart", 80, 1, 8, 89
"d:\Flutter\old_version\lib\controller\auth\register_controller.dart", "Dart", 315, 19, 22, 356
"d:\Flutter\old_version\lib\controller\buying\buying_controller.dart", "Dart", 649, 33, 50, 732
"d:\Flutter\old_version\lib\controller\buying\buying_details_view_controller.dart", "Dart", 209, 8, 16, 233
"d:\Flutter\old_version\lib\controller\buying\definition_buying_controller.dart", "Dart", 349, 24, 25, 398
"d:\Flutter\old_version\lib\controller\cashier\cashier_constant_controller.dart", "Dart", 559, 123, 13, 695
"d:\Flutter\old_version\lib\controller\cashier\cashier_controller.dart", "Dart", 1061, 56, 104, 1221
"d:\Flutter\old_version\lib\controller\cashier\cashier_definition_controller.dart", "Dart", 80, 25, 4, 109
"d:\Flutter\old_version\lib\controller\catagories\catagories_add_controller.dart", "Dart", 55, 1, 7, 63
"d:\Flutter\old_version\lib\controller\catagories\catagories_view_controller.dart", "Dart", 90, 3, 11, 104
"d:\Flutter\old_version\lib\controller\catagories\categories_edit_controller.dart", "Dart", 46, 0, 8, 54
"d:\Flutter\old_version\lib\controller\home\account_controller.dart", "Dart", 82, 0, 5, 87
"d:\Flutter\old_version\lib\controller\home\add_admin_controller.dart", "Dart", 82, 0, 5, 87
"d:\Flutter\old_version\lib\controller\home\home_controller.dart", "Dart", 117, 2, 14, 133
"d:\Flutter\old_version\lib\controller\imp_exp\edit_import_export_controller.dart", "Dart", 141, 41, 14, 196
"d:\Flutter\old_version\lib\controller\imp_exp\export_controller.dart", "Dart", 175, 4, 14, 193
"d:\Flutter\old_version\lib\controller\imp_exp\import_controller.dart", "Dart", 167, 5, 16, 188
"d:\Flutter\old_version\lib\controller\imp_exp\import_export_controller.dart", "Dart", 285, 36, 21, 342
"d:\Flutter\old_version\lib\controller\inventory\edit_import_export_controller.dart", "Dart", 145, 3, 11, 159
"d:\Flutter\old_version\lib\controller\inventory\inventory_controller.dart", "Dart", 1234, 25, 140, 1399
"d:\Flutter\old_version\lib\controller\inventory\inventory_definitions_controller.dart", "Dart", 358, 15, 23, 396
"d:\Flutter\old_version\lib\controller\items\items_add_controller.dart", "Dart", 194, 6, 19, 219
"d:\Flutter\old_version\lib\controller\items\items_definition_controller.dart", "Dart", 365, 15, 40, 420
"d:\Flutter\old_version\lib\controller\items\items_update_controller.dart", "Dart", 122, 2, 16, 140
"d:\Flutter\old_version\lib\controller\items\items_view_controller.dart", "Dart", 338, 14, 31, 383
"d:\Flutter\old_version\lib\controller\printer\invoice_controller.dart", "Dart", 1557, 132, 124, 1813
"d:\Flutter\old_version\lib\controller\printer\sunmi_printer_controller.dart", "Dart", 255, 13, 21, 289
"d:\Flutter\old_version\lib\controller\setting\back_up_controller.dart", "Dart", 222, 20, 36, 278
"d:\Flutter\old_version\lib\controller\setting\currency_controller.dart", "Dart", 15, 0, 4, 19
"d:\Flutter\old_version\lib\controller\setting\language_controller.dart", "Dart", 21, 0, 5, 26
"d:\Flutter\old_version\lib\controller\setting\security_controller.dart", "Dart", 91, 5, 12, 108
"d:\Flutter\old_version\lib\controller\setting\setting_controller.dart", "Dart", 213, 4, 12, 229
"d:\Flutter\old_version\lib\core\class\crud.dart", "Dart", 64, 7, 7, 78
"d:\Flutter\old_version\lib\core\class\statusrequest.dart", "Dart", 9, 0, 0, 9
"d:\Flutter\old_version\lib\core\constant\app_theme.dart", "Dart", 80, 0, 11, 91
"d:\Flutter\old_version\lib\core\constant\color.dart", "Dart", 17, 2, 5, 24
"d:\Flutter\old_version\lib\core\constant\dev_config.dart", "Dart", 7, 3, 2, 12
"d:\Flutter\old_version\lib\core\constant\imgaeasset.dart", "Dart", 17, 4, 3, 24
"d:\Flutter\old_version\lib\core\constant\routes.dart", "Dart", 124, 14, 5, 143
"d:\Flutter\old_version\lib\core\constant\screen_routes.dart", "Dart", 40, 7, 3, 50
"d:\Flutter\old_version\lib\core\dialogs\auth_dialog.dart", "Dart", 130, 0, 5, 135
"d:\Flutter\old_version\lib\core\dialogs\confirm_dialog.dart", "Dart", 56, 0, 5, 61
"d:\Flutter\old_version\lib\core\dialogs\custom_snack_bar.dart", "Dart", 54, 3, 3, 60
"d:\Flutter\old_version\lib\core\dialogs\delete_dialog.dart", "Dart", 42, 0, 2, 44
"d:\Flutter\old_version\lib\core\dialogs\error_dialogs.dart", "Dart", 50, 0, 5, 55
"d:\Flutter\old_version\lib\core\functions\calculate_discount.dart", "Dart", 11, 0, 3, 14
"d:\Flutter\old_version\lib\core\functions\change_direction.dart", "Dart", 12, 0, 3, 15
"d:\Flutter\old_version\lib\core\functions\check_internet.dart", "Dart", 11, 0, 2, 13
"d:\Flutter\old_version\lib\core\functions\combine_products_name.dart", "Dart", 50, 3, 3, 56
"d:\Flutter\old_version\lib\core\functions\custom_scroll.dart", "Dart", 7, 0, 2, 9
"d:\Flutter\old_version\lib\core\functions\formating_numbers.dart", "Dart", 18, 0, 5, 23
"d:\Flutter\old_version\lib\core\functions\handing_data_controller.dart", "Dart", 8, 0, 2, 10
"d:\Flutter\old_version\lib\core\functions\handle_data_function.dart", "Dart", 30, 0, 2, 32
"d:\Flutter\old_version\lib\core\functions\handle_data_function_mobile.dart", "Dart", 32, 0, 2, 34
"d:\Flutter\old_version\lib\core\functions\keyboard_listener.dart", "Dart", 21, 0, 3, 24
"d:\Flutter\old_version\lib\core\functions\show_popup_menu.dart", "Dart", 45, 2, 4, 51
"d:\Flutter\old_version\lib\core\functions\upload_file.dart", "Dart", 17, 1, 4, 22
"d:\Flutter\old_version\lib\core\functions\validinput.dart", "Dart", 34, 0, 10, 44
"d:\Flutter\old_version\lib\core\localization\changelocal.dart", "Dart", 27, 1, 7, 35
"d:\Flutter\old_version\lib\core\localization\text_routes.dart", "Dart", 289, 11, 1, 301
"d:\Flutter\old_version\lib\core\localization\translation.dart", "Dart", 537, 15, 5, 557
"d:\Flutter\old_version\lib\core\middleware\mymiddleware.dart", "Dart", 26, 2, 4, 32
"d:\Flutter\old_version\lib\core\responsive\divide_screen_widget.dart", "Dart", 22, 0, 3, 25
"d:\Flutter\old_version\lib\core\responsive\responisve_text_body.dart", "Dart", 22, 11, 3, 36
"d:\Flutter\old_version\lib\core\responsive\responsive_builder.dart", "Dart", 23, 2, 6, 31
"d:\Flutter\old_version\lib\core\responsive\responsive_icons.dart", "Dart", 22, 11, 3, 36
"d:\Flutter\old_version\lib\core\services\services.dart", "Dart", 39, 1, 9, 49
"d:\Flutter\old_version\lib\core\shared\custom_appbar_title.dart", "Dart", 35, 0, 2, 37
"d:\Flutter\old_version\lib\core\shared\custom_buttton_global.dart", "Dart", 39, 0, 2, 41
"d:\Flutter\old_version\lib\core\shared\custom_divider.dart", "Dart", 8, 0, 2, 10
"d:\Flutter\old_version\lib\core\shared\custom_drop_down_laptop_details.dart", "Dart", 211, 1, 7, 219
"d:\Flutter\old_version\lib\core\shared\custom_drop_down_search.dart", "Dart", 103, 2, 6, 111
"d:\Flutter\old_version\lib\core\shared\custom_drop_down_search_items.dart", "Dart", 182, 1, 8, 191
"d:\Flutter\old_version\lib\core\shared\custom_drop_down_search_users.dart", "Dart", 171, 1, 7, 179
"d:\Flutter\old_version\lib\core\shared\custom_floating_button.dart", "Dart", 21, 0, 3, 24
"d:\Flutter\old_version\lib\core\shared\custom_formfield_global.dart", "Dart", 109, 2, 4, 115
"d:\Flutter\old_version\lib\core\shared\custom_header_screen.dart", "Dart", 67, 1, 3, 71
"d:\Flutter\old_version\lib\core\shared\custom_search_widget.dart", "Dart", 82, 1, 4, 87
"d:\Flutter\old_version\lib\core\shared\custom_sized_box.dart", "Dart", 7, 0, 2, 9
"d:\Flutter\old_version\lib\core\shared\custom_table_header_global.dart", "Dart", 44, 1, 3, 48
"d:\Flutter\old_version\lib\core\shared\custom_table_headers.dart", "Dart", 16, 0, 2, 18
"d:\Flutter\old_version\lib\core\shared\custom_table_widget.dart", "Dart", 42, 3, 2, 47
"d:\Flutter\old_version\lib\data\model\box_model.dart", "Dart", 30, 0, 3, 33
"d:\Flutter\old_version\lib\data\model\cart_model.dart", "Dart", 150, 0, 4, 154
"d:\Flutter\old_version\lib\data\model\categories_model.dart", "Dart", 14, 0, 5, 19
"d:\Flutter\old_version\lib\data\model\creditor_debtor_details_model.dart", "Dart", 24, 0, 3, 27
"d:\Flutter\old_version\lib\data\model\debtors_model.dart", "Dart", 26, 0, 5, 31
"d:\Flutter\old_version\lib\data\model\export_model.dart", "Dart", 47, 0, 2, 49
"d:\Flutter\old_version\lib\data\model\import_model.dart", "Dart", 33, 0, 3, 36
"d:\Flutter\old_version\lib\data\model\invoice_model.dart", "Dart", 53, 0, 3, 56
"d:\Flutter\old_version\lib\data\model\items_model.dart", "Dart", 211, 7, 7, 225
"d:\Flutter\old_version\lib\data\model\laptop_model.dart", "Dart", 112, 2, 4, 118
"d:\Flutter\old_version\lib\data\model\locale\custom_selected_list_items.dart", "Dart", 14, 0, 2, 16
"d:\Flutter\old_version\lib\data\model\locale\custom_selected_list_users.dart", "Dart", 14, 0, 2, 16
"d:\Flutter\old_version\lib\data\model\locale\custom_units_list.dart", "Dart", 10, 0, 2, 12
"d:\Flutter\old_version\lib\data\model\locale\inventory_list_data.dart", "Dart", 13, 0, 2, 15
"d:\Flutter\old_version\lib\data\model\purchaes_model.dart", "Dart", 68, 2, 4, 74
"d:\Flutter\old_version\lib\data\model\total_profit_model.dart", "Dart", 30, 0, 3, 33
"d:\Flutter\old_version\lib\data\model\types_model.dart", "Dart", 14, 0, 3, 17
"d:\Flutter\old_version\lib\data\model\units_model.dart", "Dart", 26, 0, 3, 29
"d:\Flutter\old_version\lib\data\model\users_model.dart", "Dart", 32, 0, 2, 34
"d:\Flutter\old_version\lib\data\source\auth\register_class.dart", "Dart", 86, 0, 9, 95
"d:\Flutter\old_version\lib\data\source\auth_class.dart", "Dart", 24, 0, 5, 29
"d:\Flutter\old_version\lib\data\source\buying_class.dart", "Dart", 81, 0, 7, 88
"d:\Flutter\old_version\lib\data\source\cashier_class.dart", "Dart", 493, 38, 50, 581
"d:\Flutter\old_version\lib\data\source\imp_exp\export_class.dart", "Dart", 82, 0, 9, 91
"d:\Flutter\old_version\lib\data\source\imp_exp\import_class.dart", "Dart", 81, 0, 6, 87
"d:\Flutter\old_version\lib\data\source\inventory_data\box_class.dart", "Dart", 193, 4, 20, 217
"d:\Flutter\old_version\lib\data\source\inventory_data\budget_data.dart", "Dart", 37, 0, 9, 46
"d:\Flutter\old_version\lib\data\source\inventory_data\creditor_deptor_class.dart", "Dart", 89, 0, 6, 95
"d:\Flutter\old_version\lib\data\source\inventory_data\expenses_class.dart", "Dart", 79, 0, 5, 84
"d:\Flutter\old_version\lib\data\source\inventory_data\imp_exp_class.dart", "Dart", 144, 4, 13, 161
"d:\Flutter\old_version\lib\data\source\inventory_data\invoice_class.dart", "Dart", 112, 0, 7, 119
"d:\Flutter\old_version\lib\data\source\inventory_data\profit_inventory_class.dart", "Dart", 170, 0, 8, 178
"d:\Flutter\old_version\lib\data\source\items_class.dart", "Dart", 104, 5, 15, 124
"d:\Flutter\old_version\lib\data\source\users_class.dart", "Dart", 53, 0, 11, 64
"d:\Flutter\old_version\lib\data\sql\sqldb.dart", "Dart", 153, 8, 26, 187
"d:\Flutter\old_version\lib\main.dart", "Dart", 58, 0, 6, 64
"d:\Flutter\old_version\lib\view\auth\login\login_screen.dart", "Dart", 188, 1, 7, 196
"d:\Flutter\old_version\lib\view\auth\system_auth\register_system_screen.dart", "Dart", 226, 0, 7, 233
"d:\Flutter\old_version\lib\view\auth\system_auth\verify_account_screen.dart", "Dart", 127, 0, 6, 133
"d:\Flutter\old_version\lib\view\buying\buying_screen.dart", "Dart", 16, 0, 3, 19
"d:\Flutter\old_version\lib\view\buying\components\buying_table_view.dart", "Dart", 139, 29, 5, 173
"d:\Flutter\old_version\lib\view\buying\components\buying_text_field.dart", "Dart", 128, 1, 7, 136
"d:\Flutter\old_version\lib\view\buying\components\custom_dropdown_buying.dart", "Dart", 99, 2, 5, 106
"d:\Flutter\old_version\lib\view\buying\mobile\buying_screen_mobile.dart", "Dart", 295, 4, 3, 302
"d:\Flutter\old_version\lib\view\buying\mobile\view_buying_details_screen_mobile.dart", "Dart", 63, 0, 3, 66
"d:\Flutter\old_version\lib\view\buying\windows\add_buying\add_buying_table.dart", "Dart", 46, 0, 3, 49
"d:\Flutter\old_version\lib\view\buying\windows\buying_screen_windows.dart", "Dart", 298, 4, 3, 305
"d:\Flutter\old_version\lib\view\buying\windows\view_buying\view_buying_table.dart", "Dart", 172, 1, 5, 178
"d:\Flutter\old_version\lib\view\buying\windows\view_details\view_buying_details_screen.dart", "Dart", 153, 0, 3, 156
"d:\Flutter\old_version\lib\view\cashier\cashier_screen.dart", "Dart", 135, 10, 14, 159
"d:\Flutter\old_version\lib\view\cashier\mobile\cashier_screen_mobile.dart", "Dart", 130, 2, 3, 135
"d:\Flutter\old_version\lib\view\cashier\mobile\components\bottom_cashier_buttons.dart", "Dart", 354, 0, 3, 357
"d:\Flutter\old_version\lib\view\cashier\mobile\components\custom_payment_dialog_mobile.dart", "Dart", 156, 6, 9, 171
"d:\Flutter\old_version\lib\view\cashier\mobile\components\footer_details_widget.dart", "Dart", 103, 6, 6, 115
"d:\Flutter\old_version\lib\view\cashier\mobile\components\pending_carts_mobile.dart", "Dart", 149, 0, 3, 152
"d:\Flutter\old_version\lib\view\cashier\mobile\components\search_widget_mobile.dart", "Dart", 63, 1, 3, 67
"d:\Flutter\old_version\lib\view\cashier\mobile\components\table_widget.dart", "Dart", 45, 0, 4, 49
"d:\Flutter\old_version\lib\view\cashier\windows\action\cashier_right_side.dart", "Dart", 210, 5, 3, 218
"d:\Flutter\old_version\lib\view\cashier\windows\action\components\custom_cashier_dialog.dart", "Dart", 74, 0, 3, 77
"d:\Flutter\old_version\lib\view\cashier\windows\action\components\custom_diplay_users.dart", "Dart", 157, 2, 7, 166
"d:\Flutter\old_version\lib\view\cashier\windows\action\components\export_pdf_dialog.dart", "Dart", 109, 0, 2, 111
"d:\Flutter\old_version\lib\view\cashier\windows\action\components\payment_dialog.dart", "Dart", 188, 3, 4, 195
"d:\Flutter\old_version\lib\view\cashier\windows\action\components\show_last_invoices.dart", "Dart", 85, 0, 3, 88
"d:\Flutter\old_version\lib\view\cashier\windows\view\cashier_left_side_screen.dart", "Dart", 158, 7, 8, 173
"d:\Flutter\old_version\lib\view\cashier\windows\view\components\cashier_drop_down.dart", "Dart", 66, 0, 4, 70
"d:\Flutter\old_version\lib\view\cashier\windows\view\components\cashier_table_rows.dart", "Dart", 164, 0, 5, 169
"d:\Flutter\old_version\lib\view\cashier\windows\view\components\custom_grid_data_view.dart", "Dart", 254, 6, 5, 265
"d:\Flutter\old_version\lib\view\cashier\windows\view\components\custom_pending_cart.dart", "Dart", 135, 0, 3, 138
"d:\Flutter\old_version\lib\view\cashier\windows\view\components\display_quantity_field.dart", "Dart", 70, 4, 3, 77
"d:\Flutter\old_version\lib\view\cashier\windows\view\components\search_box_widget.dart", "Dart", 22, 0, 3, 25
"d:\Flutter\old_version\lib\view\cashier\windows\view\components\show_drop_down_items_dialog.dart", "Dart", 155, 0, 5, 160
"d:\Flutter\old_version\lib\view\categories\catagories_screen.dart", "Dart", 19, 0, 3, 22
"d:\Flutter\old_version\lib\view\categories\mobile\add_categories_mobile.dart", "Dart", 55, 0, 3, 58
"d:\Flutter\old_version\lib\view\categories\mobile\categories_screen_mobile.dart", "Dart", 129, 1, 3, 133
"d:\Flutter\old_version\lib\view\categories\windows\add_catagories_widget.dart", "Dart", 53, 0, 3, 56
"d:\Flutter\old_version\lib\view\categories\windows\categries_screen_windows.dart", "Dart", 84, 2, 3, 89
"d:\Flutter\old_version\lib\view\categories\windows\edit_categories_screen.dart", "Dart", 58, 0, 3, 61
"d:\Flutter\old_version\lib\view\categories\windows\view_categories_widget.dart", "Dart", 106, 1, 3, 110
"d:\Flutter\old_version\lib\view\home\desktop\home_logo.dart", "Dart", 14, 0, 2, 16
"d:\Flutter\old_version\lib\view\home\desktop\home_screen_windows.dart", "Dart", 33, 0, 3, 36
"d:\Flutter\old_version\lib\view\home\desktop\home_widget_list.dart", "Dart", 93, 1, 4, 98
"d:\Flutter\old_version\lib\view\home\drawer\acount_screen.dart", "Dart", 170, 0, 4, 174
"d:\Flutter\old_version\lib\view\home\drawer\add_admin_screen.dart", "Dart", 187, 0, 3, 190
"d:\Flutter\old_version\lib\view\home\drawer\custom_home_drawer.dart", "Dart", 169, 0, 3, 172
"d:\Flutter\old_version\lib\view\home\home_screen.dart", "Dart", 36, 0, 3, 39
"d:\Flutter\old_version\lib\view\home\mobile\home_logo_mobile.dart", "Dart", 11, 0, 2, 13
"d:\Flutter\old_version\lib\view\home\mobile\home_screen_mobile.dart", "Dart", 30, 0, 3, 33
"d:\Flutter\old_version\lib\view\home\mobile\how_widget_list_mobile.dart", "Dart", 73, 1, 2, 76
"d:\Flutter\old_version\lib\view\import_export\desktop\export\export_add_widget.dart", "Dart", 122, 0, 3, 125
"d:\Flutter\old_version\lib\view\import_export\desktop\export\export_screen.dart", "Dart", 96, 5, 5, 106
"d:\Flutter\old_version\lib\view\import_export\desktop\export\export_search_widget.dart", "Dart", 229, 0, 3, 232
"d:\Flutter\old_version\lib\view\import_export\desktop\export\export_table_widget.dart", "Dart", 182, 14, 6, 202
"d:\Flutter\old_version\lib\view\import_export\desktop\import\import_add_widget.dart", "Dart", 117, 0, 3, 120
"d:\Flutter\old_version\lib\view\import_export\desktop\import\import_screen.dart", "Dart", 87, 5, 4, 96
"d:\Flutter\old_version\lib\view\import_export\desktop\import\import_search_widget.dart", "Dart", 222, 0, 3, 225
"d:\Flutter\old_version\lib\view\import_export\desktop\import\import_table_widget.dart", "Dart", 180, 14, 6, 200
"d:\Flutter\old_version\lib\view\import_export\import_export_screen.dart", "Dart", 18, 0, 4, 22
"d:\Flutter\old_version\lib\view\import_export\mobile\export\export_add_widget_mobile.dart", "Dart", 120, 0, 3, 123
"d:\Flutter\old_version\lib\view\import_export\mobile\export\export_screen_mobile.dart", "Dart", 58, 0, 4, 62
"d:\Flutter\old_version\lib\view\import_export\mobile\export\export_search_widget_mobile.dart", "Dart", 178, 0, 3, 181
"d:\Flutter\old_version\lib\view\import_export\mobile\import\import_add_widget_mobile.dart", "Dart", 112, 0, 3, 115
"d:\Flutter\old_version\lib\view\import_export\mobile\import\import_screen_mobile.dart", "Dart", 106, 0, 4, 110
"d:\Flutter\old_version\lib\view\import_export\mobile\import\import_search_widget_mobile.dart", "Dart", 173, 0, 3, 176
"d:\Flutter\old_version\lib\view\import_export\shared\custom_drop_down_impexp.dart", "Dart", 116, 1, 5, 122
"d:\Flutter\old_version\lib\view\import_export\shared\custom_expansion_tile.dart", "Dart", 67, 0, 3, 70
"d:\Flutter\old_version\lib\view\import_export\shared\edit_import_export.dart", "Dart", 114, 0, 4, 118
"d:\Flutter\old_version\lib\view\inventory\components\inventory_custom_stack.dart", "Dart", 38, 9, 3, 50
"d:\Flutter\old_version\lib\view\inventory\inventory_screen.dart", "Dart", 16, 0, 3, 19
"d:\Flutter\old_version\lib\view\inventory\mobile\inventory_screen_mobile.dart", "Dart", 291, 2, 5, 298
"d:\Flutter\old_version\lib\view\inventory\windows\box\all_invoices_table_box.dart", "Dart", 143, 0, 4, 147
"d:\Flutter\old_version\lib\view\inventory\windows\box\box_table_rows.dart", "Dart", 172, 0, 4, 176
"d:\Flutter\old_version\lib\view\inventory\windows\box\custom_box_widget.dart", "Dart", 239, 4, 3, 246
"d:\Flutter\old_version\lib\view\inventory\windows\budget\budget_screen.dart", "Dart", 141, 0, 7, 148
"d:\Flutter\old_version\lib\view\inventory\windows\creditor\creditor_table_rows.dart", "Dart", 116, 0, 3, 119
"d:\Flutter\old_version\lib\view\inventory\windows\creditor\view_creditor_details.dart", "Dart", 173, 3, 4, 180
"d:\Flutter\old_version\lib\view\inventory\windows\custom_drop_down_inventory.dart", "Dart", 104, 17, 5, 126
"d:\Flutter\old_version\lib\view\inventory\windows\debtor\debtor_table_rows.dart", "Dart", 116, 0, 3, 119
"d:\Flutter\old_version\lib\view\inventory\windows\debtor\view_debtor_details.dart", "Dart", 156, 4, 5, 165
"d:\Flutter\old_version\lib\view\inventory\windows\expense\expense_table_rows.dart", "Dart", 187, 0, 4, 191
"d:\Flutter\old_version\lib\view\inventory\windows\export\export_table_rows.dart", "Dart", 193, 0, 4, 197
"d:\Flutter\old_version\lib\view\inventory\windows\import\import_table_rows.dart", "Dart", 192, 1, 3, 196
"d:\Flutter\old_version\lib\view\inventory\windows\inventory_screen_windows.dart", "Dart", 226, 2, 4, 232
"d:\Flutter\old_version\lib\view\inventory\windows\profits\profits_table_rows.dart", "Dart", 215, 0, 3, 218
"d:\Flutter\old_version\lib\view\inventory\windows\total_profit\all_invoices_table.dart", "Dart", 140, 0, 4, 144
"d:\Flutter\old_version\lib\view\inventory\windows\total_profit\custom_total_profits_widgets.dart", "Dart", 126, 3, 3, 132
"d:\Flutter\old_version\lib\view\items\items_screen.dart", "Dart", 14, 0, 4, 18
"d:\Flutter\old_version\lib\view\items\mobile\add_items_screen_mobile.dart", "Dart", 27, 0, 3, 30
"d:\Flutter\old_version\lib\view\items\mobile\items_screen_mobile.dart", "Dart", 129, 0, 5, 134
"d:\Flutter\old_version\lib\view\items\mobile\update_items_screen_mobile.dart", "Dart", 27, 0, 3, 30
"d:\Flutter\old_version\lib\view\items\widget\custom_add_items.dart", "Dart", 166, 5, 4, 175
"d:\Flutter\old_version\lib\view\items\widget\custom_show_items.dart", "Dart", 237, 0, 4, 241
"d:\Flutter\old_version\lib\view\items\widget\custom_update_widget.dart", "Dart", 167, 5, 5, 177
"d:\Flutter\old_version\lib\view\items\widget\mobile_action_widget.dart", "Dart", 188, 0, 6, 194
"d:\Flutter\old_version\lib\view\items\windows\items_add_screen.dart", "Dart", 91, 0, 3, 94
"d:\Flutter\old_version\lib\view\items\windows\items_screen_windows.dart", "Dart", 228, 0, 4, 232
"d:\Flutter\old_version\lib\view\items\windows\items_update_screen.dart", "Dart", 60, 0, 3, 63
"d:\Flutter\old_version\lib\view\settings\components\back_up_widget.dart", "Dart", 183, 1, 7, 191
"d:\Flutter\old_version\lib\view\settings\components\custom_dropdown_setting.dart", "Dart", 165, 2, 8, 175
"d:\Flutter\old_version\lib\view\settings\components\custom_textfield_setting.dart", "Dart", 51, 1, 3, 55
"d:\Flutter\old_version\lib\view\settings\components\language_card.dart", "Dart", 45, 0, 3, 48
"d:\Flutter\old_version\lib\view\settings\components\security_widget.dart", "Dart", 155, 0, 3, 158
"d:\Flutter\old_version\lib\view\settings\invoices\custom_drop_down_items_invoice.dart", "Dart", 153, 1, 6, 160
"d:\Flutter\old_version\lib\view\settings\invoices\mobile\invoice_screen_mobile.dart", "Dart", 77, 0, 3, 80
"d:\Flutter\old_version\lib\view\settings\invoices\shared\design_barcode.dart", "Dart", 126, 5, 5, 136
"d:\Flutter\old_version\lib\view\settings\invoices\shared\design_page.dart", "Dart", 622, 50, 4, 676
"d:\Flutter\old_version\lib\view\settings\invoices\shared\printing_barcode.dart", "Dart", 47, 0, 3, 50
"d:\Flutter\old_version\lib\view\settings\invoices\shared\printing_widget.dart", "Dart", 251, 1, 6, 258
"d:\Flutter\old_version\lib\view\settings\invoices\windows\invoices_screen_windows.dart", "Dart", 103, 2, 4, 109
"d:\Flutter\old_version\lib\view\settings\mobile\back_up_screen_mobile.dart", "Dart", 19, 0, 3, 22
"d:\Flutter\old_version\lib\view\settings\mobile\customers_details_mobile.dart", "Dart", 139, 3, 4, 146
"d:\Flutter\old_version\lib\view\settings\mobile\language_screen_mobile.dart", "Dart", 49, 0, 3, 52
"d:\Flutter\old_version\lib\view\settings\mobile\security_screen_mobile.dart", "Dart", 24, 0, 3, 27
"d:\Flutter\old_version\lib\view\settings\mobile\setting_screen_mobile.dart", "Dart", 83, 2, 3, 88
"d:\Flutter\old_version\lib\view\settings\mobile\system_update_mobile.dart", "Dart", 90, 1, 3, 94
"d:\Flutter\old_version\lib\view\settings\setting_screen.dart", "Dart", 20, 0, 3, 23
"d:\Flutter\old_version\lib\view\settings\windows\right_side_widget.dart", "Dart", 96, 4, 3, 103
"d:\Flutter\old_version\lib\view\settings\windows\setting_screen_windows.dart", "Dart", 39, 0, 3, 42
"d:\Flutter\old_version\lib\view\settings\windows\tabs\backup_screen_windows.dart", "Dart", 25, 0, 3, 28
"d:\Flutter\old_version\lib\view\settings\windows\tabs\currency_windows.dart", "Dart", 47, 0, 3, 50
"d:\Flutter\old_version\lib\view\settings\windows\tabs\customers_details_windows.dart", "Dart", 236, 0, 3, 239
"d:\Flutter\old_version\lib\view\settings\windows\tabs\language_screen_windows.dart", "Dart", 51, 0, 3, 54
"d:\Flutter\old_version\lib\view\settings\windows\tabs\security_screen_windows.dart", "Dart", 26, 0, 3, 29
"d:\Flutter\old_version\lib\view\settings\windows\tabs\system_update_screen_windows.dart", "Dart", 99, 1, 3, 103
"d:\Flutter\old_version\lib\view\widgets\tables\custom_table_cell.dart", "Dart", 29, 0, 2, 31
"d:\Flutter\old_version\lib\view\widgets\tables\custom_table_cell_change_number.dart", "Dart", 46, 0, 2, 48
"d:\Flutter\old_version\lib\view\widgets\tables\custom_table_headers.dart", "Dart", 26, 0, 2, 28
"d:\Flutter\old_version\lib\view\widgets\tables\custom_table_widget.dart", "Dart", 56, 16, 5, 77
"Total", "-", 31807, 1102, 1836, 34745